1111111111
1P000C01E1
1C01011101
1C01010101
111C0C00C1
1111111111