1111111111111111111111111111
100C00000001000110E000000011
101100010010010110C010C0C111
1C11000100C1001110C010C0C111
1011000100C01010C0C010C0C111
1011000100C110C0C0C010C0C111
1011000100C00C0C0C0100C0C111
1CCC000100C11111C0C0C0C0C111
101100010P0C10C0C0C010C0C111
1011000100C10111C101C0C01011
1011000100C0C0C1C101C0C01111
1011000100C0C0C1C101C0C00111
1111111111111111111111111111