11111111111111111111111111111
10101010101010101010101010101
1C00000000000000000000000P0C1
10000000001001111000000000001
10000100101001000000000000001
10001101101001000000000000001
10001001001111111000000000E01
10000000000001001000000000001
10000000000001001000000000001
10000000001111001000000000001
1C0000000000000000000000000C1
10101010101010101010101010101
11111111111111111111111111111
