11111111111
1PCE1111111
11111111111