1111111
1C10001
1000001
1000P01
1C0E001
1000C01
1111111
