1111111
1C10001
1000001
1100P01
1C1E101
1000C01
1111111